#Civs
ABS = "countries/Abyssinia.txt"
ACM = "countries/Achaemenids.txt"
AQT = "countries/Aquitaine.txt"
ARB = "countries/Abbasids.txt"
AST = "countries/Australia.txt"
ASY	= "countries/Assyria.txt"
ATH = "countries/Athens.txt"
AUS = "countries/Austria.txt"
HSN = "countries/Ayyubids.txt"
AZT = "countries/Aztec.txt"
BAB	= "countries/Babylon.txt"
BRZ = "countries/Brazil.txt"
BYZ = "countries/Byzantium.txt"
CAN = "countries/Canada.txt"
CFG	= "countries/Carthage.txt"
CEL	= "countries/Celts.txt"	
COL = "countries/Colombia.txt"
CZH = "countries/Zhou.txt"
DAN = "countries/Denmark.txt"
EGY = "countries/Egypt.txt"
ETH = "countries/Ethiopia.txt"
ENG = "countries/England.txt"
FRA = "countries/France.txt"
GAU = "countries/Gaul.txt"
GEO = "countries/Georgia.txt"
GER = "countries/Germany.txt"
HJO = "countries/Hojo.txt"
HJP = "countries/HojoJapan.txt"
HND	= "countries/India.txt"
HNZ	= "countries/Huns.txt"
HRE = "countries/HolyRomanEmpire.txt"
HUN = "countries/Hungary.txt"
INC = "countries/Inca.txt"
IRO = "countries/Iroquois.txt"
JAP = "countries/Japan.txt"
KHM = "countries/Khmer.txt"
KON = "countries/Kongo.txt"
KOR = "countries/Korea.txt"
KRU = "countries/KievanRus.txt"
MAC = "countries/Macedon.txt"
INO = "countries/Indonesia.txt"
MAL = "countries/Mali.txt"
MAO = "countries/Maori.txt"
MON = "countries/Mongolia.txt"
MOR = "countries/Morocco.txt"
MPC = "countries/Mapuche.txt"
MRY	= "countries/Maurya.txt"
NED = "countries/Netherlands.txt"
NOR = "countries/Norway.txt"
NRJ = "countries/Naranjo.txt"
NBI = "countries/Nubia.txt"
ODA = "countries/Oda.txt"
PER = "countries/Persia.txt"
PHO	= "countries/Phoenicia.txt"
PLQ = "countries/Palenque.txt"
PLY	= "countries/Polynesia.txt"
POL = "countries/Poland.txt"
POR = "countries/Portugal.txt"
QIN = "countries/Qin.txt"
ROM = "countries/Rome.txt"
RUS = "countries/Russia.txt"
SCO = "countries/Scotland.txt"
SCY	= "countries/Scythia.txt"
SHO = "countries/Shoshone.txt"
SIA = "countries/Siam.txt"
SMR	= "countries/Sumeria.txt"
SON = "countries/Songhai.txt"
SPA = "countries/Spain.txt"
SPR	= "countries/Sparta.txt"
SSR	= "countries/SovietUnion.txt"
SWE = "countries/Sweden.txt"
TUR = "countries/Ottomans.txt"
USA = "countries/America.txt"
VEN = "countries/Venice.txt"
VTM = "countries/Vietnam.txt"
WCR = "countries/Cree.txt"
ZUL	= "countries/Zulu.txt"

#City-States
LAN	= "countries/cs/Florence.txt"
BLG = "countries/cs/Bologna.txt"
MLO	= "countries/cs/Milan.txt"
GEN	= "countries/cs/Genoa.txt"
GNV = "countries/cs/Geneva.txt"
HAM	= "countries/cs/Hamburg.txt"
GRA	= "countries/cs/Granada.txt"
FEZ	= "countries/cs/Fez.txt"
RAG	= "countries/cs/Ragusa.txt"
RIG	= "countries/cs/Riga.txt"
JER = "countries/cs/Jerusalem.txt"
KTU = "countries/cs/Kathmandu.txt"
BEI	= "countries/cs/Brunei.txt"
MLC	= "countries/cs/Malacca.txt"
QUE	= "countries/cs/Quebec.txt"
MBA = "countries/cs/Mombasa.txt"
KND = "countries/cs/Kandy.txt" #Stage 0 #Original tags
ATC = "countries/cs/Antioch.txt"
CDF = "countries/cs/Cardiff.txt"
HTT = "countries/cs/Hattusa.txt"
KAB = "countries/cs/Kabul.txt"
MHJ = "countries/cs/Mohenjo.txt"
SMT = "countries/cs/Somnath.txt"
GOA = "countries/cs/Goa.txt"
MUS = "countries/cs/Muscat.txt"
ORM = "countries/cs/Ormuz.txt"
PSL = "countries/cs/Preslav.txt"
VLT = "countries/cs/Valetta.txt"
YER = "countries/cs/Yerevan.txt"
SMK = "countries/cs/Samarkand.txt"
CBO = "countries/cs/Colombo.txt"
BUC = "countries/cs/Bucharest.txt"
MNC = "countries/cs/Monaco.txt"
PRA = "countries/cs/Prague.txt"
ZUR = "countries/cs/Zurich.txt"
BGR = "countries/cs/Belgrade.txt"
LHA = "countries/cs/Lhasa.txt"
SFI = "countries/cs/Sofia.txt"		#Stage 1
WTT = "countries/cs/Wittenberg.txt"
OSL = "countries/cs/Oslo.txt"
ALM = "countries/cs/Almaty.txt"
HNK = "countries/cs/HongKong.txt"
SEU = "countries/cs/Seoul.txt"
MNL = "countries/cs/Manila.txt"
SGP = "countries/cs/Singapore.txt"
KLL = "countries/cs/KualaLumpur.txt"
JAK = "countries/cs/Jakarta.txt"
KYZ = "countries/cs/Kyzyl.txt"
MEL = "countries/cs/Melbourne.txt"
WEL = "countries/cs/Wellington.txt"
BNA = "countries/cs/BuenosAires.txt"
NZC = "countries/cs/Nazca.txt"
PNM = "countries/cs/Panama.txt"
CAH = "countries/cs/Cahokia.txt"
VAN = "countries/cs/Vancouver.txt"
ATN = "countries/cs/Antananarivo.txt"
MDI = "countries/cs/Mogadishu.txt"
ZNZ = "countries/cs/Zanzibar.txt"
VIL = "countries/cs/Vilnius.txt"
HEL = "countries/cs/Helsinki.txt"		#Stage 2
AYU = "countries/cs/Ayutthaya.txt"
NAN = "countries/cs/NanMadol.txt"
LHR = "countries/cs/Lahore.txt"
WLN = "countries/cs/Wolin.txt"
KMS = "countries/cs/Kumasi.txt"
TRG = "countries/cs/Taruga.txt"
IFE = "countries/cs/Ife.txt"
NGZ = "countries/cs/Ngazargamu.txt"
JHN = "countries/cs/Johanessburg.txt"
CPT = "countries/cs/Cape.txt"
RPN = "countries/cs/RapaNui.txt"
HZA = "countries/cs/Hunza.txt"
MTL = "countries/cs/Mitla.txt"
CGN = "countries/cs/Caguana.txt"
TRN = "countries/cs/Toronto.txt"		#Stage 3